INPUT 5x5x5

- - - - -
- 0 0 0 -
- 0 - 0 -
- 0 0 0 -
- - - - -

- 0 0 0 -
0 X X X 0
0 X G X 0
0 X X X 0
- 0 0 0 -

- 0 - 0 -
0 X 0 X 0
- 0 - 0 -
0 X 0 X 0
- 0 - 0 -

- 0 0 0 -
0 X X X 0
0 X S X 0
0 X X X 0
- 0 0 0 -

- - - - -
- 0 0 0 -
- 0 - 0 -
- 0 0 0 -
- - - - -

OUTPUT 2 steps

